NO ./path_to_the_north_texture.xpm
SO ./path_to_the_south_texture.xpm
WE ./path_to_the_west_texture.xpm
EA ./path_to_the_east_texture.xpm

F 10,220,148
C 0,255,255

111111111111111111111111111111
100111111111111111111111111101
101000000000000000000000000001
101000000000000000000000000001
101000000000000000000000000001
101000000000000000000000000001
101000000000000000000000000001
101000000000000000000000000001
1010000000000000N00000000000001
101000000000000000000000000001
101000000000000000000000000001
101000000000000000000000000001
1010000000011110000000000000001
101000000000000000000000000001
11000000000000000000000000001
111111111111111111111111111111
