NO ./assets/textures/path_to_the_north_texture.xpm
SO ./assets/textures/path_to_the_south_texture.xpm
WE ./assets/textures/path_to_the_west_texture.xpm
EA ./assets/textures/path_to_the_east_texture.xpm

C 230,230,250
F 211,211,211

        11111111111111111
        1N00000000110001
        10011000001110001
        1101000000000001
111111111011000001110001
10000000001100000111011111111
111101111111110011000000100001
11110111111111111111111111111
1100111
100000011111111111111111111111
1000000000000000110101001000111111111
1100000111010101111101111000111
11110111 1110101 101111010001
11111111 1111111 111111111111






