NO     ./assets/textures/path_to_the_north_texture.xpm
SO ./assets/textures/path_to_the_south_texture.xpm
WE ./assets/textures/path_to_the_west_texture.xpm
EA ./assets/textures/path_to_the_east_texture.xpm

C       103 ,193      ,  22
F 125  ,  130  ,   140

        11111111111111111
        1000000000110001
        1011000001110001
        1001000000000001
111111111011000001110001
10000000001100000111011111111
11110111111111011100000010001
11110111111111011101010010001
110000001110N01011100000010001
10000000000000001100000010001
10000000000000001101010010001
1100000111010101111101111000111
11110111 1110101 101111010001
11111111 1111111 111111111111
