NO ./path_to_the_north_texture.xpm
SO ./path_to_the_south_texture.xpm
WE ./path_to_the_west_texture.xpm
EA ./path_to_the_east_texture.xpm

F 10,220,148
C 0,255,255

1111111111111111111111111111111111111111111111111111111111111111111111111111
1001111111111111111111111111010011111111111111111111111110111111111111111111
1010000000000000000000000000000100000000000000000000000000000000000000000011
101000000000000000000000000000000000000000000000000000000000000000000000011
101000000000000000000000000000000000000000000000000000000000000000000000011
101000000000000000000000000000000000000000000000000000000000000000000000011
101000000000000000000000000000000000000000000000000000000000000000000000011
101000000000000000000000000000000000000000000000000000000000000000000000011
1010000000000000N0000000000000000000000000000000000000000000000000000000011
101000000000000000000000000000000000000000000000000000000000000000000000011
101000000000000000000000000000000000000000000000000000000000000000000000011
101000000000000000000000000001000000000000000000000000000111111111111111111
1010000000011110000000000000010100000000111100000000000000011111111111111111
1010000000000000000000000000010100000000000000000000000000111111111111111111
1100000000000000000000000000111000000000000000000000000001111111111111111111
1111111111111111111111111111111111111111111111111111111111111111111111111111
